EA textures/east.png
NO textures/north.png
SO textures/south.png
WE textures/west.png

F 254,100,0
C 50,0,255

111111111111111111
110000S00000000001
111111101111111111
100000000000000001
100000000000000001
111111111111111111