EA textures/east.png
NO textures/north.png
SO textures/south.png
WE textures/west.png

F 254,100,0
C 50,0,255

        1111111111111111111111111
        1000000000110000000000001
        10110000011100000W0000001
        1001000000000000000000001
111111111011000001110000000000001
100000000011000001110111111111111
111101111111110111000000100011
111101111111110111000100000011
110000001101010111000000100011
100000000000000011000000100011
100000000000000011010100110011
110000011101010011101110100111
11110111 1110101 1011110100011
11111111 1111111 1111111111111