EA ./path_to_the_east_texture
NO ./path_to_the_north_texture
SO ./path_to_the_south_texture
WE ./path_to_the_west_texture

F 20,0,0
C 100,0,255

        1111111111111111111111111
        1000000000110000000000001
        1011000001110000000000001
        1001000000000000000000001
111111111011000001110000000000001
100000000011000001110111111111111
111101111111110111000000100011
111101111111110111010100000011
110000001101010111000000100011
100000000000000011000000100011
100000000000000011010100100011
1100000111010100111011110N0111
11110111 1110101 1011110100011
11111111 1111111 1111111111111
